4,2,1,9,8,5,6,3,7
8,3,5,1,7,6,9,2,4
9,6,7,2,4,3,8,1,5
1,4,6,3,5,7,2,9,8
3,7,9,8,6,2,5,4,1
2,5,8,4,9,1,7,6,3
5,8,4,6,1,9,3,7,2
7,9,2,5,3,4,1,8,6
6,1,3,7,2,8,4,5,9
