9,3,4,7,1,2,6,5,8
1,6,2,9,8,5,7,3,4
8,7,5,3,4,6,2,1,9
2,9,7,1,6,3,4,8,5
4,5,3,8,7,9,1,2,6
6,8,1,2,5,4,9,7,3
5,4,8,6,2,7,3,9,1
7,1,9,4,3,8,5,6,2
3,2,6,5,9,1,8,4,7
