4,7,8,9,6,2,3,5,1
3,2,5,4,1,7,9,6,8
6,9,1,8,3,5,7,2,4
9,3,6,5,2,4,8,1,7
2,8,4,6,7,1,5,3,9
1,5,7,3,8,9,2,4,6
8,6,2,1,9,3,4,7,5
5,1,3,7,4,8,6,9,2
7,4,9,2,5,6,1,8,3
