5,9,6,3,4,7,2,1,8
3,1,4,5,8,2,9,7,6
7,8,2,9,6,1,4,3,5
4,3,9,6,1,8,5,2,7
1,2,5,4,7,9,8,6,3
8,6,7,2,5,3,1,9,4
2,5,1,7,3,4,6,8,9
6,7,8,1,9,5,3,4,2
9,4,3,8,2,6,7,5,1
