1,5,9,3,8,4,2,7,6
2,4,6,7,9,5,8,3,1
8,7,3,2,1,6,5,9,4
3,1,4,5,6,8,7,2,9
6,8,5,9,7,2,1,4,3
7,9,2,4,3,1,6,8,5
9,2,8,1,5,3,4,6,7
5,6,7,8,4,9,3,1,2
4,3,1,6,2,7,9,5,8
