7,5,9,3,1,4,6,2,8
8,3,4,7,2,6,5,9,1
2,1,6,8,9,5,4,3,7
5,9,7,2,4,8,3,1,6
4,2,8,1,6,3,7,5,9
1,6,3,9,5,7,2,8,4
3,4,5,6,8,9,1,7,2
6,8,1,5,7,2,9,4,3
9,7,2,4,3,1,8,6,5
