1,6,5,2,8,7,3,9,4
2,7,9,3,4,5,1,8,6
3,4,8,9,1,6,2,7,5
4,5,7,1,2,8,9,6,3
9,1,3,5,6,4,7,2,8
6,8,2,7,3,9,5,4,1
7,9,4,6,5,1,8,3,2
8,3,1,4,7,2,6,5,9
5,2,6,8,9,3,4,1,7
