3,6,5,1,2,7,8,9,4
9,1,7,4,8,3,6,5,2
2,8,4,6,5,9,3,1,7
7,2,9,5,1,8,4,6,3
8,3,1,7,4,6,9,2,5
5,4,6,9,3,2,7,8,1
1,5,8,3,6,4,2,7,9
4,7,2,8,9,1,5,3,6
6,9,3,2,7,5,1,4,8
