1,4,3,5,7,9,2,6,8
2,5,9,4,8,6,3,1,7
7,8,6,1,3,2,9,5,4
4,7,2,8,9,5,1,3,6
3,1,5,6,4,7,8,9,2
6,9,8,2,1,3,7,4,5
8,3,1,7,5,4,6,2,9
5,2,7,9,6,1,4,8,3
9,6,4,3,2,8,5,7,1
