8,3,7,6,1,4,2,5,9
2,5,4,3,9,8,1,6,7
6,1,9,2,5,7,3,4,8
1,8,3,7,2,6,4,9,5
9,6,2,4,8,5,7,3,1
7,4,5,1,3,9,8,2,6
3,9,8,5,7,2,6,1,4
4,7,1,9,6,3,5,8,2
5,2,6,8,4,1,9,7,3
